# Datatypes
RadarIQCommand_t	KEYWORD1
RadarIQReturnVal_t	KEYWORD1
RadarIQCaptureMode_t	KEYWORD1
RadarIQMovingFilterMode_t	KEYWORD1
RadarIQResetCode_t	KEYWORD1
RadarIQPointDensity_t	KEYWORD1


# Structures
RadarIQ_t	KEYWORD3
RadarIQDataPoint_t	KEYWORD3
RadarIQDataPointCloud_t	KEYWORD3
RadarIQDataObject_t	KEYWORD3
RadarIQDataObjectTracking_t	KEYWORD3
RadarIQData_t	KEYWORD3
RadarIQChipTemperatures_t	KEYWORD3
RadarIQProcessingStats_t	KEYWORD3
RadarIQStatistics_t	KEYWORD3
RadarIQVersion_t	KEYWORD3
RadarIQVersionIWR_t	KEYWORD3
RadarIQSerialNo_t	KEYWORD3
RadarIQUartData_t	KEYWORD3


# Functions
RadarIQ_reset	KEYWORD2
RadarIQ_save	KEYWORD2
RadarIQ_getVersion	KEYWORD2
RadarIQ_getRadarVersions	KEYWORD2
RadarIQ_getSerialNumber	KEYWORD2
RadarIQ_getFrameRate	KEYWORD2
RadarIQ_setFrameRate	KEYWORD2
RadarIQ_getMode	KEYWORD2
RadarIQ_setMode	KEYWORD2
RadarIQ_getDistanceFilter	KEYWORD2
RadarIQ_setDistanceFilter	KEYWORD2
RadarIQ_getAngleFilter	KEYWORD2
RadarIQ_setAngleFilter	KEYWORD2
RadarIQ_getMovingFilter	KEYWORD2
RadarIQ_setMovingFilter	KEYWORD2
RadarIQ_getPointDensity	KEYWORD2
RadarIQ_setPointDensity	KEYWORD2
RadarIQ_getCertainty	KEYWORD2
RadarIQ_setCertainty	KEYWORD2
RadarIQ_getHeightFilter	KEYWORD2
RadarIQ_setHeightFilter	KEYWORD2
RadarIQ_sceneCalibrate	KEYWORD2
RadarIQ_getObjectSize	KEYWORD2
RadarIQ_setObjectSize	KEYWORD2

# Constants
RADARIQ_RX_BUFFER_SIZE	LITERAL1
RADARIQ_MAX_POINTCLOUD	LITERAL1
RADARIQ_MAX_OBJECTS	LITERAL1
RADARIQ_MAX_MESSAGE_STRING	LITERAL1
RADARIQ_MAX_FRAME_RATE	LITERAL1
RADARIQ_MIN_DIST_FILT	LITERAL1
RADARIQ_MAX_DIST_FILT	LITERAL1
RADARIQ_MIN_ANGLE_FILT	LITERAL1
RADARIQ_MAX_ANGLE_FILT	LITERAL1
RADARIQ_MAX_CERTAINTY	LITERAL1
RADARIQ_MAX_OBJ_SIZE	LITERAL1
RADARIQ_CMD_NONE	LITERAL1
RADARIQ_CMD_ERROR	LITERAL1
RADARIQ_CMD_UNKNOWN	LITERAL1
RADARIQ_CMD_MESSAGE	LITERAL1
RADARIQ_CMD_VERSION	LITERAL1
RADARIQ_CMD_SERIAL	LITERAL1
RADARIQ_CMD_RESET	LITERAL1
RADARIQ_CMD_FRAME_RATE	LITERAL1
RADARIQ_CMD_MODE	LITERAL1
RADARIQ_CMD_DIST_FILT	LITERAL1
RADARIQ_CMD_ANGLE_FILT	LITERAL1
RADARIQ_CMD_MOVING_FILT	LITERAL1
RADARIQ_CMD_SAVE	LITERAL1
RADARIQ_CMD_PNT_DENSITY	LITERAL1
RADARIQ_CMD_CERTAINTY	LITERAL1
RADARIQ_CMD_HEIGHT_FILT	LITERAL1
RADARIQ_CMD_IWR_VERSION	LITERAL1
RADARIQ_CMD_SCENE_CALIB	LITERAL1
RADARIQ_CMD_OBJECT_SIZE	LITERAL1
RADARIQ_CMD_CAPTURE_START	LITERAL1
RADARIQ_CMD_CAPTURE_STOP	LITERAL1
RADARIQ_CMD_PNT_CLOUD_FRAME	LITERAL1
RADARIQ_CMD_OBJ_TRACKING_FRAME	LITERAL1
RADARIQ_CMD_PROC_STATS	LITERAL1
RADARIQ_CMD_RAW_DATA	LITERAL1
RADARIQ_CMD_POINTCLOUD_STATS	LITERAL1
RADARIQ_CMD_POWER_STATUS	LITERAL1
RADARIQ_RETURN_VAL_OK	LITERAL1
RADARIQ_RETURN_VAL_WARNING	LITERAL1
RADARIQ_RETURN_VAL_ERR	LITERAL1
RADARIQ_MODE_POINT_CLOUD	LITERAL1
RADARIQ_MODE_OBJECT_TRACKING	LITERAL1
RADARIQ_MODE_RAW_DATA	LITERAL1
RADARIQ_MOVING_BOTH	LITERAL1
RADARIQ_MOVING_OBJECTS_ONLY	LITERAL1
RADARIQ_RESET_REBOOT	LITERAL1
RADARIQ_RESET_FACTORY_SETTINGS	LITERAL1
RADARIQ_DENSITY_NORMAL	LITERAL1
RADARIQ_DENSITY_DENSE	LITERAL1